Sales Order #,Customer,Order Date,Promise Date,Item,Order Quantity,QOH,Remaining QOH,days_past_prom_dt,edw_load_dtm
266717,WEB,08/16/2022,08/23/2022,SWV6WH,2,2,0,8,2022-08-31 06:40:15
267135,WEB,08/22/2022,08/29/2022,SDWV10SR.875,2,2,0,2,2022-08-31 06:40:15
267135,WEB,08/22/2022,08/29/2022,SDWV7SR.875,1,1,0,2,2022-08-31 06:40:15
267135,WEB,08/22/2022,08/29/2022,DWV4SR.875,3,3,0,2,2022-08-31 06:40:14
267135,WEB,08/22/2022,08/29/2022,FP14,1,1,0,2,2022-08-31 06:40:14
267135,WEB,08/22/2022,08/29/2022,FP8,2,2,0,2,2022-08-31 06:40:14
266690,AMAZ,08/15/2022,08/30/2022,SDB121212,1,1,0,1,2022-08-31 06:40:15
266712,AMAZ,08/16/2022,08/30/2022,FR1420,1,2,1,1,2022-08-31 06:40:14
266764,AMAZ,08/16/2022,08/30/2022,SDWV6BK,1,4,3,1,2022-08-31 06:40:15
267172,WEB,08/23/2022,08/30/2022,SDB884,2,2,0,1,2022-08-31 06:40:15
267172,WEB,08/23/2022,08/30/2022,SDB886,6,7,1,1,2022-08-31 06:40:15
267173,WEB,08/23/2022,08/30/2022,WVEB10A,1,1,0,1,2022-08-31 06:40:15
267177,WEB,08/23/2022,08/30/2022,WDC7SS,1,1,0,1,2022-08-31 06:40:15
267177,WEB,08/23/2022,08/30/2022,WDC9SS,1,1,0,1,2022-08-31 06:40:15
267182,WEB,08/23/2022,08/30/2022,DWV7,4,34,30,1,2022-08-31 06:40:14
267182,WEB,08/23/2022,08/30/2022,BK8,2,22,20,1,2022-08-31 06:40:14
267182,WEB,08/23/2022,08/30/2022,DWV10,1,4,3,1,2022-08-31 06:40:14
267184,WEB,08/23/2022,08/30/2022,SWV4,2,12,10,1,2022-08-31 06:40:15
267184,WEB,08/23/2022,08/30/2022,WVEB6,1,5,4,1,2022-08-31 06:40:15
267185,WEB,08/23/2022,08/30/2022,SDB181816,2,2,0,1,2022-08-31 06:40:15
267192,WEB,08/23/2022,08/30/2022,CTS10,1,3,2,1,2022-08-31 06:40:14
267193,WEB,08/23/2022,08/30/2022,SR10R,1,1,0,1,2022-08-31 06:40:15
267193,WEB,08/23/2022,08/30/2022,WVEB10BR,1,1,0,1,2022-08-31 06:40:15
267198,WEB,08/23/2022,08/30/2022,SDWV10BR,3,3,0,1,2022-08-31 06:40:15
267198,WEB,08/23/2022,08/30/2022,SDWV6BR,6,14,8,1,2022-08-31 06:40:15
267198,WEB,08/23/2022,08/30/2022,SDWV8BR,6,10,4,1,2022-08-31 06:40:15
267200,WEB,08/23/2022,08/30/2022,CTS12,1,1,0,1,2022-08-31 06:40:14
267210,WEB,08/23/2022,08/30/2022,BDS7,1,1,0,1,2022-08-31 06:40:14
267210,WEB,08/23/2022,08/30/2022,SDB887,1,1,0,1,2022-08-31 06:40:15
267214,WEB,08/23/2022,08/30/2022,CTS10,1,2,1,1,2022-08-31 06:40:14
267221,WEB,08/23/2022,08/30/2022,CTS6,1,1,0,1,2022-08-31 06:40:14
267226,WEB,08/23/2022,08/30/2022,WVEB4,8,8,0,1,2022-08-31 06:40:15
267235,WEB,08/23/2022,08/30/2022,GN5BK,1,1,0,1,2022-08-31 06:40:14
267235,WEB,08/23/2022,08/30/2022,GN5XBK,1,1,0,1,2022-08-31 06:40:14
267236,WEB,08/23/2022,08/30/2022,SDB16168,1,1,0,1,2022-08-31 06:40:15
267252,WEB,08/23/2022,08/30/2022,SDB10109,1,1,0,1,2022-08-31 06:40:15
267252,WEB,08/23/2022,08/30/2022,SDB101010,2,2,0,1,2022-08-31 06:40:15
267457,AMAZ,08/26/2022,08/30/2022,WVEB6A,1,1,0,1,2022-08-31 06:40:15
266772,AMAZ,08/16/2022,08/31/2022,VC6SS,1,1,0,0,2022-08-31 06:40:15
266790,AMAZ,08/17/2022,08/31/2022,SDWV3WH,1,1,0,0,2022-08-31 06:40:15
266792,AMAZ,08/17/2022,08/31/2022,SDWV8BR,1,4,3,0,2022-08-31 06:40:15
266796,AMAZ,08/17/2022,08/31/2022,DWV4CU,1,1,0,0,2022-08-31 06:40:14
266796,AMAZ,08/17/2022,08/31/2022,DWV6CU,4,28,24,0,2022-08-31 06:40:14
266819,AMAZ,08/17/2022,08/31/2022,SWV4,2,10,8,0,2022-08-31 06:40:15
267255,WEB,08/24/2022,08/31/2022,WVEB6BK,2,70,68,0,2022-08-31 06:40:15
267256,WEB,08/24/2022,08/31/2022,WVEB10WH,1,2,1,0,2022-08-31 06:40:15
267260,WEB,08/24/2022,08/31/2022,WVEB8,1,17,16,0,2022-08-31 06:40:15
267261,WEB,08/24/2022,08/31/2022,TR83,1,1,0,0,2022-08-31 06:40:15
267263,WEB,08/24/2022,08/31/2022,WVEB6BK,2,68,66,0,2022-08-31 06:40:15
267264,WEB,08/24/2022,08/31/2022,BK6XCU,1,11,10,0,2022-08-31 06:40:14
267267,WEB,08/24/2022,08/31/2022,SWV6BK,2,5,3,0,2022-08-31 06:40:15
267267,WEB,08/24/2022,08/31/2022,WVEB4BK,2,142,140,0,2022-08-31 06:40:15
267267,WEB,08/24/2022,08/31/2022,BK6XBK,2,26,24,0,2022-08-31 06:40:14
267267,WEB,08/24/2022,08/31/2022,SWV4BK,2,11,9,0,2022-08-31 06:40:15
267267,WEB,08/24/2022,08/31/2022,WVEB6BK,2,66,64,0,2022-08-31 06:40:15
267275,WEB,08/24/2022,08/31/2022,UEVD4WH,3,773,770,0,2022-08-31 06:40:15
267275,WEB,08/24/2022,08/31/2022,SWV4BK,2,9,7,0,2022-08-31 06:40:15
267276,WEB,08/24/2022,08/31/2022,SDWV4BK,1,9,8,0,2022-08-31 06:40:15
267282,WEB,08/24/2022,08/31/2022,TR63,1,1,0,0,2022-08-31 06:40:15
267285,WEB,08/24/2022,08/31/2022,V816WH,5,5,0,0,2022-08-31 06:40:15
267298,WEB,08/24/2022,08/31/2022,VS616BR,20,20,0,0,2022-08-31 06:40:15
267301,WEB,08/24/2022,08/31/2022,BK4XBK,30,165,135,0,2022-08-31 06:40:14
267301,WEB,08/24/2022,08/31/2022,BK4XBR,15,115,100,0,2022-08-31 06:40:14
267301,WEB,08/24/2022,08/31/2022,JVO38BK,30,98,68,0,2022-08-31 06:40:14
267317,WEB,08/24/2022,08/31/2022,SWV4A,1,20,19,0,2022-08-31 06:40:15
267317,WEB,08/24/2022,08/31/2022,SWV6A,1,40,39,0,2022-08-31 06:40:15
267318,WEB,08/24/2022,08/31/2022,CTS16,1,1,0,0,2022-08-31 06:40:14
267320,WEB,08/24/2022,08/31/2022,WVEB6BK,1,64,63,0,2022-08-31 06:40:15
267321,WEB,08/24/2022,08/31/2022,WVEB6WH,1,20,19,0,2022-08-31 06:40:15
267323,WEB,08/24/2022,08/31/2022,SWV4WH,1,6,5,0,2022-08-31 06:40:15
267326,WEB,08/24/2022,08/31/2022,WVEB8BR,1,1,0,0,2022-08-31 06:40:15
267329,WEB,08/24/2022,08/31/2022,VC6SS,1,2,1,0,2022-08-31 06:40:15
